5 9
*#######*
#.......#
#.......#
#....*..#
*#######*