5 9
########*
#.......#
#.......#
#....*..#
*#######*