5 9
#########
#......P#
#...C...#
#.....E.#
#########