5 9
#########
#......P#
#...CC..#
#....EE.#
#########