5 9
#########
#E......#
#.C.....#
#......P#
#########