16 16
*****######*****
*****#....#*****
***##......#****
***##......#****
**##........#***
##...##.....#***
#............#**
##......###..#**
####.....#...#**
***#........#***
###........#****
***########*****