12 16
*****######*****
*****#....#*****
***##.P....#****
***##......#****
**##........#***
##...##...E.#***
#............#**
##......###..#**
####.....#...#**
***#...C....#***
###........#****
***########*****