7 8
#######*
#..E..#*
#.C.#.##
#E#C.C.#
#..E#..#
#...#.P#
########
