12 16
*****######*****
*****#....#*****
***##.P....#****
***##......#****
**##......E.#***
##...##...E.#***
#............#**
##......###..#**
####.....#...#**
***#..CC....#***
###........#****
***########*****