6 6
######
#...*#
#....#
#*.#.#
#..*.#
######