6 6
######
#PC.E#
#CC..#
#E.#.#
#..E.#
######