6 7
**#####
###..P#
#ECE#.#
#.CCC.#
#E.E..#
#######