6 7
####***
#PE####
#CC...#
#EC.#.#
#...E.#
#######