6 7
####***
#.*####
#.....#
#*..#.#
#..*..#
#######