7 7
#######
#P....#
#...C.#
##.#C.#
#..#..#
#E..E##
#######
