7 8
########
#EP#...#
#..#...#
#...CC.#
#..#.#.#
#.....E#
########