9 10
##########
#P.......#
#######.##
#E..##.C.#
#...#....#
##.##..#.#
#........#
#........#
##########
